currency.DictionarySlot Валюта, в которой клиент хочет открыть счёт	В какой валюте хотите открыть счёт?
RUB	рубли, рублевый, российская валюта,рубль, рублей, в рублях, в отечественной валюте, в нашей валюте, ₽, р., руб.
USD	баксы, доллары,иностранная валюта, не в нашей валюте, доллар, в долларах, в иностранной валюте, $, dollar, валютный счёт
EUR	евро, в евро, euro, €
AUD	австралийские доллары, в австралийских долларах
CAD	канадские доллары, в канадских долларах
CHF	швейцарские франки, в швейцарских франках
DKK	датские кроны, в датских кронах
GBP	фунты стерлингов Соединенного Королевства, в фунтах стерлингов Соединенного Королевства, £
JPY	японские иены, в японских иенах
NOK	норвежские кроны, в норвежских кронах
SEK	шведские кроны, в шведских кронах
SGD	сингапурские доллары, в сингапурских долларах
	
client_type.DictionarySlot Категория клиента	Какой тип организации, для которого хотите открыть счёт? (ИП, ООО, физическое лицо и пр.)
физическое лицо	физическое лицо, физ. лицо, физик, частное лицо, частный клиент, обычный человек, ФЛ
юридическое лицо	компания, фирма, организация, юрик, юридическое лицо, ЮЛ, юр. лицо, ООО, ОАО, ЗАО, ПАО
индивидуальный предприниматель	индивидуальный предприниматель, ИП, ипэшник, предприниматель, частный предприниматель
коммерческие организации	хозяйственное товарищество, хозяйственное общество, хоз. общества, полное товарищество, товарищество на вере, общество с ограниченной ответственностью, ООО, публичное акционерное общество, ПАО, не публичное акционерное общество, крестьянское хозяйство, фермерское хозяйство, хозяйственное партнерство, производственный корпоратив, государственное унитарное предприятие, муниципальное унитарное предприятие, общество с дополнительной ответственностью, ОДО, общество при одном учредителе, открытое акционерное общество, ОАО, закрытое акционерное общество, ЗАО, общественное движение, орган общественной самодеятельности, садоводческое объединение, огородническое объединение, дачное объединение, общество взаимного страхования
некоммерческие организации	потребительский кооператив, общественная организация, товарищество собственников недвижимости, товарищество собственников жилья, ассоциация, союз, община коренного малочисленного народа Российской Федерации, казачье общество, внесенное в государственный реестр казачьих обществ в Российской Федерации, некоммерческое партнерство, религиозная организация, общественный фонд, благотворительный фонд, государственное учреждение, государственная академия наук, муниципальное учреждение, частное учреждение, общественное учреждение, публично-правовая компания, автономная некоммерческая организация, государственная корпорация, коллегия адвокатов, юридическая консультация
	
account_type.DictionarySlot Тип клиента	Какой тип счёта хотите открыть? (расчётный, гособрзаказ и пр.)
Расчетный счет	счёт на юридическое лицо, расчетного счета, 275ФЗ, 275 ФЗ, онлайн-платежей от физ лиц, счет для индивидуального предпринимателя
ГосОбрЗаказ	госзаказ, гособоронзаказ, государственный заказ, счёт по гособорону, 159ФЗ, 159 ФЗ
ГосКонтракт	госконтракт, государственный контракт, счёт по госконтракту, счета госконтракта, 44ФЗ, 44 ФЗ
Обособленный банковский счет	счёт для строительства, строительный счёт, обособленный счёт
Текущий валютный счет	валютный счёт, счёт в валюте, счёт для валютных операций, иностранный счёт, счёт в иностранной валюте
Транзитный валютный счет	дополнительный счёт к валютному счёту, счёт для перечисления валюты, счёт для иностранных операций
Накопительный счет	счёт для внесения уставного капитала, временный счёт, счёт для подтверждения открытия, счёт для открытия паевого фонда, счёт для первичного внесения средств
Счет доверительного управления	счёт для инвестиций, счёт для ценных бумаг, счёт инвестиционного продукта, доверительный счёт, счёт для управления
Счет внешнего управляющего	счёт для конкурсного производства, счёт для арбитражного управляющего, арбитражный счёт, счёт внешнего управления, счёт по банкротству
Специальный счет платежного агента/банковского платежного агента/поставщика	счёт для платежей от физических лиц, счёт платёжного агента, счёт для списание денег на банковские счета, счёт для поставщика, агентский счёт
Специальный счет для формирования фонда капитального ремонта	счёт по 174ФЗ, счёт для капитального ремонта, счёт для погашения кредитов в рамках кап. ремонта, счёт в рамках жилищного кодекса, счёт для уплаты процентов по капитальному ремонту
Депозитный счет	счёт для оформления депозита, классический счёт, пополняемый счёт, отзываемый депозит, неснижаемый остаток на депозитных счетах, счёт для получения дохода
Банковское сопровождение государственных контрактов	счёт для проверки соответствия проектно-сметной документации, счёт для проверки на адресность перевода средств, счёт для проверки информации об исполнении контракта, счёт в рамках ПП963
счет для Товарищества собственников жилья	счет для ТСЖ
	
metro_station.DictionarySlot	NotImplementedTemplateMessage
Библиотека им. Ленина	библиотека, ленинка,на ленине
Чеховская	чеховка
Ленинский проспект	проспект ленина
Академическая	академической
Южная	южной
Кантемировская	кантемировка
Тульская	тульской
Тургеневская	тургеневка
Сухаревская	сухаревской
Пролетарская	пролетарка
Крестьянская Застава	застава
Водный стадион	стадион
Нагатинская	нагатинка
Кунцевская	кунцевка
Петровско-Разумовская	разумовка
Добрынинская	добрынинка
Серпуховская	серпуховка
Проспект Мира	мира
Красные Ворота	на воротах
Парк культуры	на культуре, на парке
Арбатская	арбат
Полянка	полянке
Октябрьская	октябрьской
Кропоткинская	кропоткино
Авиамоторная	авиамоторке
Щелковская	щёлковка
Марксистская	марксистской
Римская	римской
Площадь Ильича	на ильче, на площади
Полежаевская	полежаевка
Октябрьское поле	на поле
Киевская	киевской
Юго-Западная	юго-западной
Отрадное	отрадной
Текстильщики	текстильщиках
Марьино	марьино
Каховская	каховка
Новые Черемушки	черёмушках
Волоколамская	волоколамка
Профсоюзная	профсоюзной
Нахимовский проспект	нахимовка
Проспект Вернадского	на вернадском
Электрозаводская	на электрозаводском
Семеновская	на семёновке
Калужская	на калужке
бульвар Дмитрия Донского	на донском
Бабушкинская	бабушкинкой
Сокол	на соколе
Новогиреево	новогиреево
Кузнецкий Мост	на мосту
Рижская	рижской
Савеловская	на савёлках
	
show_docs.ClassifierSlot Клиент хочет, чтобы ему показали документы	Выдать перечень документов, необходимых для открытия счёта?
да	выдать, показать, естественно
нет	не нужно
	
resident.DictionarySlot Резиденство клиента	Является ли учредитель фирмы резидентом РФ?
рф	да, являюсь, резидент
не рф	нет, не резидент, не являюсь
	
region.DictionarySlot	Из какого вы региона?
Алтайский край	Алтайский
Амурская область	Амурская
Архангельская область	Архангельская
Астраханская область	Астраханская
Белгородская область	Белгородская
Брянская область	Брянская
Владимирская область	Владимирская
Волгоградская область	Волгоградская
Вологодская область	Вологодская
Воронежская область	Воронежская
Москва	Мск
Еврейская автономная область	Еврейская ао, Еврейская
Забайкальский край	Забайкальский
Ивановская область	Ивановская
космодром Байконур	Байконур
Иркутская область	Иркутская
Кабардино-Балкарская Республика	Кабардино-Балкарская, Кабардино-Балкария
Калининградская область	Калининградская
Калужская область	Калужская
Камчатский край	Камчатский
Карачаево-Черкесская Республика	Карачаево-Черкесская, Карачаево-Черкессия
Кемеровская область	Кемеровская
Кировская область	Кировская
Костромская область	Костромская
Краснодарский край	Краснодарский
Красноярский край	Красноярский 
Курганская область	Курганская
Курская область	Курская
Ленинградская область	Ленинградская
Липецкая область	Липецкая
Магаданская область	Магаданская
Московская область	Московская
Мурманская область	Мурманская
Ненецкий автономный округ	Ненецкий ао, Ненецкий, Ненецк
Нижегородская область	Нижегородская
Новгородская область	Новгородская
Новосибирская область	Новосибирская
Омская область	Омская
Оренбургская область	Оренбургская
Орловская область	Орловская
Пензенская область	Пензенская
Пермский край	Пермский
Приморский край	Приморский
Псковская область	Псковская
Республика Адыгея	Адыгея
Республика Алтай	Алтай
Республика Башкортостан	Башкортостан, Башкирия
Республика Бурятия	Бурятия
Республика Дагестан	Дагестан
Республика Ингушетия	Ингушетия
Республика Калмыкия	Калмыкия
Республика Карелия	Карелия
Республика Коми	Коми
Республика Крым	Крым
Республика Марий Эл	Марий Эл
Республика Мордовия	Мордовия
Республика Саха	Саха, Якутия
Республика Северная Осетия - Алания	Северная Осетия-Алания, Осетия-Алания
Республика Татарстан	Татарстан, Татария
Республика Тыва	Тыва
Республика Хакасия	Хакасия
Ростовская область	Ростовская
Рязанская область	Рязанская
Самарская область	Самарская
Санкт-Петербург	Ленинград, СПб, Питер
Саратовская область	Саратовская
Сахалинская область	Сахалинская
Свердловская область	Свердловская
Севастополь	
Смоленская область	Смоленская
Ставропольский край	Ставропольский
Тамбовская область	Тамбовская
Тверская область	Тверская
Томская область	Томская
Тульская область	Тульская
Тюменская область	Тюменская
Удмуртская Республика	Удмуртская, Удмуртия
Ульяновская область	Ульяновская
Хабаровский край	Хабаровский
Ханты-Мансийский автономный округ - Югра	Ханты-Мансийский, Ханты-Мансийский ао, Югра
Челябинская область	Челябинская
Чеченская Республика	Чеченская, Чечня, Ичкерия
Чувашская Республика - Чувашия	Чувашская, Чувашия
Чукотский автономный округ	Чукотский, Чукотский ао
Ямало-Ненецкий автономный округ	Ямало-Ненецкий, Ямало-Ненецкий ао
Ярославская область	Ярославская
	
online_reserving.ClassifierSlot Перейти на онлайн резервирование	"Сервис «Онлайн резервирование расчетного счета» позволит Вам получить необходимые реквизиты счета за 5 минут, не посещая отделение Банка. 

Услуга «Онлайн резервирование банковского счета» предоставляется юридическим лицам (за исключением Кредитных организаций) и индивидуальным предпринимателям, резидентам РФ, сведения о которых содержатся в Федеральной налоговой службе Российской Федерации.

Срок резервирования составляет 365 календарных дней по счету зарезервированного для целей сопровождения Государственного контракта по Государственному оборонному заказу,  с даты получения номера банковского счета.

Хотите зарезервировать счёт онлайн сейчас?"
да	хочу, да пожалуйста, ага
нет	не нужно, неа, не стоит
	
cost_of_service.ClassifierSlot Запросить стоимость услуг	Хотите ли узнать тарифы?
да	хочу, да пожалуйста, ага
нет	не нужно
